########
##   ###
## #$ ##
# $    #
#. .#  #
### @ ##
### # ##
###   ##
########