#######
#    @#
#  $  #
#.    #
#######