####################
#####   ############
#####$ $############
####    ############
###  $   ###########
### #$## ###########
#   # ## #####   ..#
# $   $          ..#
##### ### #@##   ..#
#####     ##########
####################         