#########
#####  ##
## $   ##
#  # #$##
#.@..  ##
## # #  #
##   $  #
##  #####
#########