########
#####  #
#   *  #
# *.#  #
## ## ##
# $    #
# @#   #
#  #####
########