#########
##   ####
# . . .##
# # ## ##
#    $$@#
### # $ #
###   ###
#########