########
###   ##
# $ # ##
# #  . #
#    # #
## #   #
##@   ##
########