########
##   ###
##$# ###
#  .$@ #
# #  # #
# #..$ #
#   ####
########