########
##   ###
##.#$ ##
# $    #
#. .#$ #
### @ ##
### # ##
###   ##
########