#########
##   ####
# . .  ##
# # ## ##
#    $$@#
### #   #
###   ###
#########