#######
#@    #
#   $ #
#  $  #
##    #########
#   .        .#
###############